8 8 2
O#2.#...
#.....N#
..E.....
.#L#..##
#......#
....##..
..#.T...
..#.NT.#
O.#..#..
.2.S.#.#
#...N...
.....#..
..#LN...
..#.#..#
N..#.1.N
.1......
