10 10 3
.....#....
...O.#.E..
...T.#....
..######..
..........
.###..####
.......L..
......##..
..#....#..
..#....#..
..#..#.#..
....#.....
....#.....
########..
..........
####......
...#...L..
.L.#####..
......##..
..#...#...
..#.....##
..#1....##
..####....
.....#....
.....#E###
.....##.1.
.S...#....
.....#....
..####....
..........